######################################################
##@..................................................#
####################################################.#
#..................................................#.#
#.################################################.#.#
#.#..............................................#.#.#
#.#.############################################.#.#.#
#.#.#*...........................................#.#.#
#.#.##############################################.#.#
#.#................................................#.#
#.##################################################.#
#....................................................#
######################################################
