.#####....
#....#.####
#.#..###..#
###....#..#
#...@#.#..#
###..###..#
..#..#....#
.#####.#.##
.#......##
.#.....##.
.#######..