.#####....
#....#.####
#.#..###..#
#.........#
#...@.....#
#.........#
.##.......#
.#####.#.##
.#......##
.#.....##.
.#######..