.#####....
#*...#.####
#.#..###..#
#.........#
#..@....#.#
#.........#
.##.......#
.###.#.#.##
.#......##
.#.....##.
.#####.#*..*..*..*..*..*..*..*..*..*..*..*..*..*..*..*.####...............................#.............................
#.........................................................#............................................................#
#.#..#.#.*..*..*..*..*..*..*..*..*..*..*..*..*..*..*..*.#..#...........................................................
#.#..#.#...............................................#..#.............##################.######......................
#.#..#.#...............................................#.##.............#*......................#......................
#.#..#.#...............................................#..#.............#.............#.#.....*.#......................
#.####..##.............................................##.#.............#....................#..#......................
#..#.....#.............................................#..#.............#..............#.#......#......................
#..*...*.#.............................................#.##.............#.......................#......................
#....*...#.............................................#..#.............#...*.#*#.....#.........#......................
##########..............................................#.#.............#.........#..........#.##......................
........................................................#.#.............#............#....................#............
........................................................#..................#.....#.......#.#..###......................
..........................###...........................###.............#......*#...#....#.#....#......................
..........................#...............................#.............##################.##.#.#......................
..........................###...........................#.#........#...*#..........#............#......................
........................................................#.................#...................#.#......................
........................................................###............*#.........#.............#......................
........................................................................##################.######......................
.........................................................................................#.............................
.........................................................................................................#.............
..................................................................#....................................................
......................................................................................................................#
.......................................................................................................................
.........................................................................................#.#...........................
..........................................................................................#............................