.#####....
#*...#.####
#.#..###..#
#.........#
#...@...#.#
#.........#
.##.......#
.#####.#.##
.#......##
.#.....##.
.#######..